Script started on Tue 11 Aug 2020 01:55:59 PM MSK
]0;root@localhost:~/manual_kernel_update/Homework3[?1034h[root@localhost Homework3]# lsblk 
NAME            MAJ:MIN RM  SIZE RO TYPE MOUNTPOINT
sda               8:0    0   60G  0 disk 
├─sda1            8:1    0    1G  0 part /boot
└─sda2            8:2    0   59G  0 part 
  ├─centos-root 253:0    0   37G  0 lvm  /
  ├─centos-swap 253:1    0  3.9G  0 lvm  [SWAP]
  └─centos-home 253:2    0 18.1G  0 lvm  /home
sr0              11:0    1  4.5G  0 rom  
]0;root@localhost:~/manual_kernel_update/Homework3[root@localhost Homework3]# vg[Kagrant ssh
Last login: Tue Aug 11 10:46:41 2020 from 10.0.2.2
]0;vagrant@localhost:~[?1034h[vagrant@localhost ~]$ lsblk 
NAME                    MAJ:MIN RM  SIZE RO TYPE MOUNTPOINT
sda                       8:0    0   40G  0 disk 
├─sda1                    8:1    0    1M  0 part 
├─sda2                    8:2    0    1G  0 part /boot
└─sda3                    8:3    0   39G  0 part 
  ├─VolGroup00-LogVol00 253:0    0 37.5G  0 lvm  /
  └─VolGroup00-LogVol01 253:1    0  1.5G  0 lvm  [SWAP]
sdb                       8:16   0   10G  0 disk 
sdc                       8:32   0    2G  0 disk 
sdd                       8:48   0    1G  0 disk 
sde                       8:64   0    1G  0 disk 
]0;vagrant@localhost:~[vagrant@localhost ~]$ lvmd
lvmdiskscan  lvmdump      
[vagrant@localhost ~]$ lvmdiskscan 
  WARNING: Running as a non-root user. Functionality may be unavailable.
  /run/lvm/lvmetad.socket: access failed: Permission denied
  WARNING: Failed to connect to lvmetad. Falling back to device scanning.
  /dev/mapper/control: open failed: Permission denied
  Failure to communicate with kernel device-mapper driver.
  Incompatible libdevmapper 1.02.164-RHEL7 (2019-08-27) and kernel driver (unknown version).
  0 disks
  0 partitions
  0 LVM physical volume whole disks
  0 LVM physical volumes
]0;vagrant@localhost:~[vagrant@localhost ~]$ sudo su
]0;root@localhost:/home/vagrant[?1034h[root@localhost vagrant]# lvmdiskscan 
  /dev/sda2 [       1.00 GiB] 
  /dev/sda3 [     <39.00 GiB] LVM physical volume
  /dev/sdb  [      10.00 GiB] 
  /dev/sdc  [       2.00 GiB] 
  /dev/sdd  [       1.00 GiB] 
  /dev/sde  [       1.00 GiB] 
  4 disks
  1 partition
  0 LVM physical volume whole disks
  1 LVM physical volume
]0;root@localhost:/home/vagrant[root@localhost vagrant]# pvcreate /dev/sda3 [K[K[Kb
  Physical volume "/dev/sdb" successfully created.
]0;root@localhost:/home/vagrant[root@localhost vagrant]# vgct[Kreate otus /dev/sda3 [K[K[Kb
  Volume group "otus" successfully created
]0;root@localhost:/home/vagrant[root@localhost vagrant]# lvc
lvchange   lvconvert  lvcreate   
[root@localhost vagrant]# lvcreate -l[KI[Kl[KI [K[K[K[K[K[K[K[K[K[K[K[Klvcreate -l+80%FREE -n test otus
  Logical volume "test" created.
]0;root@localhost:/home/vagrant[root@localhost vagrant]# vgdisplay otus
  --- Volume group ---
  VG Name               otus
  System ID             
  Format                lvm2
  Metadata Areas        1
  Metadata Sequence No  2
  VG Access             read/write
  VG Status             resizable
  MAX LV                0
  Cur LV                1
  Open LV               0
  Max PV                0
  Cur PV                1
  Act PV                1
  VG Size               <10.00 GiB
  PE Size               4.00 MiB
  Total PE              2559
  Alloc PE / Size       2047 / <8.00 GiB
  Free  PE / Size       512 / 2.00 GiB
  VG UUID               QIVY39-VysX-OBjc-j7CH-gVwk-xHvf-2ru3Lr
   
]0;root@localhost:/home/vagrant[root@localhost vagrant]# vgdisplay otus[Kvgdisplay otus[C otus- otusv otus[C[C[C[C[C | grep 'PV Name'
  [01;31m[KPV Name[m[K               /dev/sdb     
]0;root@localhost:/home/vagrant[root@localhost vagrant]# lvdisplay /dev/otus/test
  --- Logical volume ---
  LV Path                /dev/otus/test
  LV Name                test
  VG Name                otus
  LV UUID                pK3U5q-osyv-zgjF-r2Vl-cfCr-3SG1-xme5v7
  LV Write Access        read/write
  LV Creation host, time localhost.localdomain, 2020-08-11 11:05:49 +0000
  LV Status              available
  # open                 0
  LV Size                <8.00 GiB
  Current LE             2047
  Segments               1
  Allocation             inherit
  Read ahead sectors     auto
  - currently set to     8192
  Block device           253:2
   
]0;root@localhost:/home/vagrant[root@localhost vagrant]# vgs
  VG         #PV #LV #SN Attr   VSize   VFree
  VolGroup00   1   2   0 wz--n- <38.97g    0 
  otus         1   1   0 wz--n- <10.00g 2.00g
]0;root@localhost:/home/vagrant[root@localhost vagrant]# lvs
  LV       VG         Attr       LSize   Pool Origin Data%  Meta%  Move Log Cpy%Sync Convert
  LogVol00 VolGroup00 -wi-ao---- <37.47g                                                    
  LogVol01 VolGroup00 -wi-ao----   1.50g                                                    
  test     otus       -wi-a-----  <8.00g                                                    
]0;root@localhost:/home/vagrant[root@localhost vagrant]# lvcreate -L100M -n smalll [K[K otus
  Logical volume "small" created.
]0;root@localhost:/home/vagrant[root@localhost vagrant]# lvs
  LV       VG         Attr       LSize   Pool Origin Data%  Meta%  Move Log Cpy%Sync Convert
  LogVol00 VolGroup00 -wi-ao---- <37.47g                                                    
  LogVol01 VolGroup00 -wi-ao----   1.50g                                                    
  small    otus       -wi-a----- 100.00m                                                    
  test     otus       -wi-a-----  <8.00g                                                    
]0;root@localhost:/home/vagrant[root@localhost vagrant]# mkf
mkfifo       mkfs         mkfs.btrfs   mkfs.cramfs  mkfs.ext2    mkfs.ext3    mkfs.ext4    mkfs.minix   mkfs.xfs     
[root@localhost vagrant]# mkfs.ext4 /dev/otus/test 
mke2fs 1.42.9 (28-Dec-2013)
Filesystem label=
OS type: Linux
Block size=4096 (log=2)
Fragment size=4096 (log=2)
Stride=0 blocks, Stripe width=0 blocks
524288 inodes, 2096128 blocks
104806 blocks (5.00%) reserved for the super user
First data block=0
Maximum filesystem blocks=2147483648
64 block groups
32768 blocks per group, 32768 fragments per group
8192 inodes per group
Superblock backups stored on blocks: 
	32768, 98304, 163840, 229376, 294912, 819200, 884736, 1605632

Allocating group tables:  0/64     done                            
Writing inode tables:  0/64     done                            
Creating journal (32768 blocks): done
Writing superblocks and filesystem accounting information:  0/64     done

]0;root@localhost:/home/vagrant[root@localhost vagrant]# cd
]0;root@localhost:~[root@localhost ~]# mkdir /data
]0;root@localhost:~[root@localhost ~]# mount /dev/o
oldmem  otus/   
[root@localhost ~]# mount /dev/otus/test /data/
]0;root@localhost:~[root@localhost ~]# mount |grep /daat[K[Kta
/dev/mapper/otus-test on [01;31m[K/data[m[K type ext4 (rw,relatime,seclabel,data=ordered)
]0;root@localhost:~[root@localhost ~]# зм[K[Kpvcreate /dev/sdc
  Physical volume "/dev/sdc" successfully created.
]0;root@localhost:~[root@localhost ~]# vf[Kgextend otus /dev/sdc
  Volume group "otus" successfully extended
]0;root@localhost:~[root@localhost ~]# vg [Kdisplay -v otus |grep 'PV Name|[K'
  [01;31m[KPV Name[m[K               /dev/sdb     
  [01;31m[KPV Name[m[K               /dev/sdc     
]0;root@localhost:~[root@localhost ~]# vgs
  VG         #PV #LV #SN Attr   VSize   VFree 
  VolGroup00   1   2   0 wz--n- <38.97g     0 
  otus         2   2   0 wz--n-  11.99g <3.90g
]0;root@localhost:~[root@localhost ~]# dd if=/dev/zero of=/data/test.log bs=1M count=8000 status=progress
629145600 bytes (629 MB) copied, 1.000204 s, 629 MB/s1280311296 bytes (1.3 GB) copied, 2.005607 s, 638 MB/s1939865600 bytes (1.9 GB) copied, 3.010038 s, 644 MB/s2493513728 bytes (2.5 GB) copied, 4.016420 s, 621 MB/s3003121664 bytes (3.0 GB) copied, 5.020796 s, 598 MB/s3483369472 bytes (3.5 GB) copied, 6.038439 s, 577 MB/s3952082944 bytes (4.0 GB) copied, 7.045499 s, 561 MB/s4422893568 bytes (4.4 GB) copied, 8.051238 s, 549 MB/s4914675712 bytes (4.9 GB) copied, 9.062061 s, 542 MB/s5508169728 bytes (5.5 GB) copied, 10.064686 s, 547 MB/s6124732416 bytes (6.1 GB) copied, 11.066453 s, 553 MB/s6746537984 bytes (6.7 GB) copied, 12.067411 s, 559 MB/s7365197824 bytes (7.4 GB) copied, 13.068745 s, 564 MB/s7968129024 bytes (8.0 GB) copied, 14.069721 s, 566 MB/s
dd: error writing ‘/data/test.log’: No space left on device
7880+0 records in
7879+0 records out
8262189056 bytes (8.3 GB) copied, 14.6174 s, 565 MB/s
]0;root@localhost:~[root@localhost ~]# df _[K-Th /data/
Filesystem            Type  Size  Used Avail Use% Mounted on
/dev/mapper/otus-test ext4  7.8G  7.8G     0 100% /data
]0;root@localhost:~[root@localhost ~]# lvextend -l+80%FREE /dev/otus/test
  Size of logical volume otus/test changed from <8.00 GiB (2047 extents) to <11.12 GiB (2846 extents).
  Logical volume otus/test successfully resized.
]0;root@localhost:~[root@localhost ~]# lvs
  LV       VG         Attr       LSize   Pool Origin Data%  Meta%  Move Log Cpy%Sync Convert
  LogVol00 VolGroup00 -wi-ao---- <37.47g                                                    
  LogVol01 VolGroup00 -wi-ao----   1.50g                                                    
  small    otus       -wi-a----- 100.00m                                                    
  test     otus       -wi-ao---- <11.12g                                                    
]0;root@localhost:~[root@localhost ~]# lvsextend -l+80%FREE /dev/otus/test[C[C[C[C[C[C[C[C[C[C[C[C[C[C[C[C[C[C[C[C[21Pdf -Th /data/d if=/dev/zero of=/data/test.log bs=1M count=8000 status=progress[C[C[C[C[C[C[C[C[C[C[C[C[C[C[C[C[C[C[C[C[Cf -Th /data/[Klvextend -l+80%FREE /dev/otus/test[C[C[C[C[C[C[C[C[C[C[C[C[C[C[C[C[C[C[C[C[C[Cs[K[Kdg[Kh [K[Kf -Th /data
Filesystem            Type  Size  Used Avail Use% Mounted on
/dev/mapper/otus-test ext4  7.8G  7.8G     0 100% /data
]0;root@localhost:~[root@localhost ~]# resize2fs /dev/otus/test 
resize2fs 1.42.9 (28-Dec-2013)
Filesystem at /dev/otus/test is mounted on /data; on-line resizing required
old_desc_blocks = 1, new_desc_blocks = 2
The filesystem on /dev/otus/test is now 2914304 blocks long.

]0;root@localhost:~[root@localhost ~]# resize2fs /dev/otus/test [C[C[C[C[C[C[C[C[C[C[C[C[C[C[C[C[C[C[C[C[13Pdf -Th /data
Filesystem            Type  Size  Used Avail Use% Mounted on
/dev/mapper/otus-test ext4   11G  7.8G  2.6G  76% /data
]0;root@localhost:~[root@localhost ~]# 
]0;root@localhost:~[root@localhost ~]# 
]0;root@localhost:~[root@localhost ~]# 
]0;root@localhost:~[root@localhost ~]# 
]0;root@localhost:~[root@localhost ~]# 
]0;root@localhost:~[root@localhost ~]# umount /data/
]0;root@localhost:~[root@localhost ~]# ef2sc[K[K[K[K2f
e2freefrag  e2fsck      
[root@localhost ~]# e2fc[Ksck -fy/[K /dev/otus/test 
e2fsck 1.42.9 (28-Dec-2013)
Pass 1: Checking inodes, blocks, and sizes
Pass 2: Checking directory structure
Pass 3: Checking directory connectivity
Pass 4: Checking reference counts
Pass 5: Checking group summary information
/dev/otus/test: 12/729088 files (0.0% non-contiguous), 2105907/2914304 blocks
]0;root@localhost:~[root@localhost ~]# resize2fs /dev/otus/test [K[K[K[K[K[K[K[K[K[K[K[K[K[K[K[K[K[K[K[K[K[K[K[K[Klsv[Kblk 
NAME                    MAJ:MIN RM  SIZE RO TYPE MOUNTPOINT
sda                       8:0    0   40G  0 disk 
├─sda1                    8:1    0    1M  0 part 
├─sda2                    8:2    0    1G  0 part /boot
└─sda3                    8:3    0   39G  0 part 
  ├─VolGroup00-LogVol00 253:0    0 37.5G  0 lvm  /
  └─VolGroup00-LogVol01 253:1    0  1.5G  0 lvm  [SWAP]
sdb                       8:16   0   10G  0 disk 
├─otus-test             253:2    0 11.1G  0 lvm  
└─otus-small            253:3    0  100M  0 lvm  
sdc                       8:32   0    2G  0 disk 
└─otus-test             253:2    0 11.1G  0 lvm  
sdd                       8:48   0    1G  0 disk 
sde                       8:64   0    1G  0 disk 
]0;root@localhost:~[root@localhost ~]# lsblk [20@e2fsck -fy /dev/otus/test[C[C[C[C[C[C[C[C[C[C[C[C[C[C[C[C[C[C[C[C[Clsblk [K[K[K[K[K[K[Kresize2fs /dev/otus/test 10G
resize2fs 1.42.9 (28-Dec-2013)
Resizing the filesystem on /dev/otus/test to 2621440 (4k) blocks.
The filesystem on /dev/otus/test is now 2621440 blocks long.

]0;root@localhost:~[root@localhost ~]# resize2fs /dev/otus/test 10G[C[C[C[C[C[C[C[C[C[C[C[C[C[C[C[C[C[C[C[Clsblk [K
NAME                    MAJ:MIN RM  SIZE RO TYPE MOUNTPOINT
sda                       8:0    0   40G  0 disk 
├─sda1                    8:1    0    1M  0 part 
├─sda2                    8:2    0    1G  0 part /boot
└─sda3                    8:3    0   39G  0 part 
  ├─VolGroup00-LogVol00 253:0    0 37.5G  0 lvm  /
  └─VolGroup00-LogVol01 253:1    0  1.5G  0 lvm  [SWAP]
sdb                       8:16   0   10G  0 disk 
├─otus-test             253:2    0 11.1G  0 lvm  
└─otus-small            253:3    0  100M  0 lvm  
sdc                       8:32   0    2G  0 disk 
└─otus-test             253:2    0 11.1G  0 lvm  
sdd                       8:48   0    1G  0 disk 
sde                       8:64   0    1G  0 disk 
]0;root@localhost:~[root@localhost ~]# lvre
lvreduce  lvremove  lvrename  lvresize  
[root@localhost ~]# lvreduce /dev/otus/test -L 10G
  WARNING: Reducing active logical volume to 10.00 GiB.
  THIS MAY DESTROY YOUR DATA (filesystem etc.)
Do you really want to reduce otus/test? [y/n]: y
  Size of logical volume otus/test changed from <11.12 GiB (2846 extents) to 10.00 GiB (2560 extents).
  Logical volume otus/test successfully resized.
]0;root@localhost:~[root@localhost ~]# lsblk 
NAME                    MAJ:MIN RM  SIZE RO TYPE MOUNTPOINT
sda                       8:0    0   40G  0 disk 
├─sda1                    8:1    0    1M  0 part 
├─sda2                    8:2    0    1G  0 part /boot
└─sda3                    8:3    0   39G  0 part 
  ├─VolGroup00-LogVol00 253:0    0 37.5G  0 lvm  /
  └─VolGroup00-LogVol01 253:1    0  1.5G  0 lvm  [SWAP]
sdb                       8:16   0   10G  0 disk 
├─otus-test             253:2    0   10G  0 lvm  
└─otus-small            253:3    0  100M  0 lvm  
sdc                       8:32   0    2G  0 disk 
└─otus-test             253:2    0   10G  0 lvm  
sdd                       8:48   0    1G  0 disk 
sde                       8:64   0    1G  0 disk 
]0;root@localhost:~[root@localhost ~]# 
]0;root@localhost:~[root@localhost ~]# lsblk vreduce /dev/otus/test -L 10G[C[C[C[C[C[C[C[C[C[C[C[C[C[C[C[C[C[C[C[C[Csblk [K[Klsblk vreduce /dev/otus/test -L 10G[C[C[C[C[C[C[C[C[C[C[C[C[C[C[C[C[C[C[C[C[Csblk [K[Kmouq[Knt /dev/otus/test /data/
]0;root@localhost:~[root@localhost ~]# df -Th /data/
Filesystem            Type  Size  Used Avail Use% Mounted on
/dev/mapper/otus-test ext4  9.8G  7.8G  1.6G  84% /data
]0;root@localhost:~[root@localhost ~]# 
]0;root@localhost:~[root@localhost ~]# 
]0;root@localhost:~[root@localhost ~]# lvs /dev/otus/test
  LV   VG   Attr       LSize  Pool Origin Data%  Meta%  Move Log Cpy%Sync Convert
  test otus -wi-ao---- 10.00g                                                    
]0;root@localhost:~[root@localhost ~]# дм[K[Kvl[K[Klvcreate -L 500M -s -n test-snap /dev/otus/test
  Logical volume "test-snap" created.
]0;root@localhost:~[root@localhost ~]# vgs
  VG         #PV #LV #SN Attr   VSize   VFree 
  VolGroup00   1   2   0 wz--n- <38.97g     0 
  otus         2   3   1 wz--n-  11.99g <1.41g
]0;root@localhost:~[root@localhost ~]# sudo vgs -o +lv_size,lv_name | grep test
  otus         2   3   1 wz--n-  11.99g <1.41g  10.00g [01;31m[Ktest[m[K     
  otus         2   3   1 wz--n-  11.99g <1.41g 500.00m [01;31m[Ktest[m[K-snap
]0;root@localhost:~[root@localhost ~]# lsblk 
NAME                    MAJ:MIN RM  SIZE RO TYPE MOUNTPOINT
sda                       8:0    0   40G  0 disk 
├─sda1                    8:1    0    1M  0 part 
├─sda2                    8:2    0    1G  0 part /boot
└─sda3                    8:3    0   39G  0 part 
  ├─VolGroup00-LogVol00 253:0    0 37.5G  0 lvm  /
  └─VolGroup00-LogVol01 253:1    0  1.5G  0 lvm  [SWAP]
sdb                       8:16   0   10G  0 disk 
├─otus-small            253:3    0  100M  0 lvm  
└─otus-test-real        253:4    0   10G  0 lvm  
  ├─otus-test           253:2    0   10G  0 lvm  /data
  └─otus-test--snap     253:6    0   10G  0 lvm  
sdc                       8:32   0    2G  0 disk 
├─otus-test-real        253:4    0   10G  0 lvm  
│ ├─otus-test           253:2    0   10G  0 lvm  /data
│ └─otus-test--snap     253:6    0   10G  0 lvm  
└─otus-test--snap-cow   253:5    0  500M  0 lvm  
  └─otus-test--snap     253:6    0   10G  0 lvm  
sdd                       8:48   0    1G  0 disk 
sde                       8:64   0    1G  0 disk 
]0;root@localhost:~[root@localhost ~]# mkdi
mkdict  mkdir   
[root@localhost ~]# mkdi
mkdict  mkdir   
[root@localhost ~]# mkdir /dara[K[Kta-snap
]0;root@localhost:~[root@localhost ~]# mount /dev/otus/tea[Kst-snap /data-snap/
]0;root@localhost:~[root@localhost ~]# ll daa[Kta-[K[K[K[K[K/daa[Kta-snap/
total 8068564
drwx------. 2 root root      16384 Aug 11 11:08 [0m[01;34mlost+found[0m
-rw-r--r--. 1 root root 8262189056 Aug 11 11:14 test.log
]0;root@localhost:~[root@localhost ~]# unmo[K[K
unalias        unexpand       unicode_stop   unix_chkpwd    unlink         unset          until          
uname          unicode_start  uniq           unix_update    unlz4          unshare        unxz           
[root@localhost ~]# unmount /dat[Kta[Ka-snam[Kp
bash: unmount: command not found
]0;root@localhost:~[root@localhost ~]# unmount /data-snap[K[K[K[K[K[K[K[K[K[K[K[K[K[K[K[K[K[Kcd da[K[K/
bin/       data/      dev/       home/      lib64/     mnt/       proc/      run/       srv/       tmp/       var/       
boot/      data-snap/ etc/       lib/       media/     opt/       root/      sbin/      sys/       usr/       
[root@localhost ~]# cd /
bin/       data/      dev/       home/      lib64/     mnt/       proc/      run/       srv/       tmp/       var/       
boot/      data-snap/ etc/       lib/       media/     opt/       root/      sbin/      sys/       usr/       
[root@localhost ~]# cd /d
data/      data-snap/ dev/       
[root@localhost ~]# cd /data
]0;root@localhost:/data[root@localhost data]# u
udevadm               umount.nfs            unicode_start         unlink                unxz                  uptime                usernetctl
ul                    umount.nfs4           unicode_stop          unlz4                 update-alternatives   urlgrabber            users
ulimit                unalias               uniq                  unset                 update-ca-trust       useradd               usleep
umask                 uname                 unix_chkpwd           unshare               update-mime-database  userdel               utmpdump
umount                unexpand              unix_update           until                 update-smart-drivedb  usermod               uuidgen
[root@localhost data]# unmm[K[K[Km
umask        umount       umount.nfs   umount.nfs4  
[root@localhost data]# um
umask        umount       umount.nfs   umount.nfs4  
[root@localhost data]# umount /[K/data-snap/[K
]0;root@localhost:/data[root@localhost data]# cd
]0;root@localhost:~[root@localhost ~]# rm tesl.log
rm: cannot remove ‘tesl.log’: No such file or directory
]0;root@localhost:~[root@localhost ~]# rm tesl.log[K[K[K[K[K[K[K[K[K[K[Kls /[K
anaconda-ks.cfg  .bash_logout     .bash_profile    .bashrc          .cshrc           original-ks.cfg  .tcshrc          
[root@localhost ~]# ls /data/
lost+found/ test.log    
[root@localhost ~]# ls /data/[2@^[[1@[[1@3[1@~[1P[1P[1P[2P[1P[1P /data/r /data/m /data/[C[C[C[C[C[C[Ctest.log 
rm: remove regular file ‘/data/test.log’? y
]0;root@localhost:~[root@localhost ~]# cd d[K[K.d[K[K /data
]0;root@localhost:/data[root@localhost data]# ll
total 16
drwx------. 2 root root 16384 Aug 11 11:08 [0m[01;34mlost+found[0m
]0;root@localhost:/data[root@localhost data]# umount /[K[K[K[K[K[K[K[Kcd
]0;root@localhost:~[root@localhost ~]# umount /data
]0;root@localhost:~[root@localhost ~]# lvconvert --merge /dev/otus/test-snap 
  Merging of volume otus/test-snap started.
  otus/test: Merged: 99.94%
  otus/test: Merged: 100.00%
]0;root@localhost:~[root@localhost ~]# mount /dev/otus/test /dev/[K[K[Kata
]0;root@localhost:~[root@localhost ~]# ll /ds[Kata
total 8068564
drwx------. 2 root root      16384 Aug 11 11:08 [0m[01;34mlost+found[0m
-rw-r--r--. 1 root root 8262189056 Aug 11 11:14 test.log
]0;root@localhost:~[root@localhost ~]# lsv[Kblk 
NAME                    MAJ:MIN RM  SIZE RO TYPE MOUNTPOINT
sda                       8:0    0   40G  0 disk 
├─sda1                    8:1    0    1M  0 part 
├─sda2                    8:2    0    1G  0 part /boot
└─sda3                    8:3    0   39G  0 part 
  ├─VolGroup00-LogVol00 253:0    0 37.5G  0 lvm  /
  └─VolGroup00-LogVol01 253:1    0  1.5G  0 lvm  [SWAP]
sdb                       8:16   0   10G  0 disk 
├─otus-test             253:2    0   10G  0 lvm  /data
└─otus-small            253:3    0  100M  0 lvm  
sdc                       8:32   0    2G  0 disk 
└─otus-test             253:2    0   10G  0 lvm  /data
sdd                       8:48   0    1G  0 disk 
sde                       8:64   0    1G  0 disk 
]0;root@localhost:~[root@localhost ~]# pvcreate /dev/sd[[K{}d},}e}
  Physical volume "/dev/sdd" successfully created.
  Physical volume "/dev/sde" successfully created.
]0;root@localhost:~[root@localhost ~]# vgc
vgcfgbackup   vgcfgrestore  vgchange      vgck          vgconvert     vgcreate      
[root@localhost ~]# vgcreate vg0 /dev/sd{}d},}e}
  Volume group "vg0" successfully created
]0;root@localhost:~[root@localhost ~]# lvcreate -Ll[K[Kl+80%FREE -m1 -n mirror vg0
  Logical volume "mirror" created.
]0;root@localhost:~[root@localhost ~]# lvs
  LV       VG         Attr       LSize   Pool Origin Data%  Meta%  Move Log Cpy%Sync Convert
  LogVol00 VolGroup00 -wi-ao---- <37.47g                                                    
  LogVol01 VolGroup00 -wi-ao----   1.50g                                                    
  small    otus       -wi-a----- 100.00m                                                    
  test     otus       -wi-ao----  10.00g                                                    
  mirror   vg0        rwi-a-r--- 816.00m                                    93.86           
]0;root@localhost:~[root@localhost ~]# lvs
  LV       VG         Attr       LSize   Pool Origin Data%  Meta%  Move Log Cpy%Sync Convert
  LogVol00 VolGroup00 -wi-ao---- <37.47g                                                    
  LogVol01 VolGroup00 -wi-ao----   1.50g                                                    
  small    otus       -wi-a----- 100.00m                                                    
  test     otus       -wi-ao----  10.00g                                                    
  mirror   vg0        rwi-a-r--- 816.00m                                    100.00          
]0;root@localhost:~[root@localhost ~]# exit
exit
]0;vagrant@localhost:~[vagrant@localhost ~]$ exit
logout
Connection to 127.0.0.1 closed.
]0;root@localhost:~/manual_kernel_update/Homework3[root@localhost Homework3]# vagrant ssh[5Plsblk vagrant ssh[4Preboot [3Pip afconfig [K[1Pdfu [1Pfifconfig [5Pp areboot vagrant ssh[5Plsblk vagrant ssh[K
]0;root@localhost:~/manual_kernel_update/Homework3[root@localhost Homework3]# 
]0;root@localhost:~/manual_kernel_update/Homework3[root@localhost Homework3]# sx [K[Kcript[K[K[K[K[K[Kxit[K[K[Kexit
exit

Script done on Tue 11 Aug 2020 02:47:06 PM MSK
